0000000000000T1000000000000001000000000000000000
000000700000001000000000000001000000000000000000
400020000000001000000000000001000000000000000000
000000000000001000000000000001000000000000000000
000016161100001000011111100001000111111111111000
005010000100001000000000100000000100000100000000
000010000100001000000000100000000100000100000000
000010000200001000000000100000000100000100008000
000010000000001000000000100000000100000100000000
000016161111111111110000111111000100000100011111
000000000100000000010000000001000100000100010000
000008000100000000010000200001000000000100010000
000000000100000800060000000001000000000602010000
000000000100000000010000000001000000000100010000
111110000100001111110000100001000000000102010000
000000000000001000000000100001111111111100000000
000000000000001000000000100000000010000000000000
000000000000001000020000100000000010000000000000
000000000000001000000000100000000010000020000000
000011111111111000010000111111111110000011111111
000000000000000000010000000001000000000000000000
000000000000000000010000000001000800000000000200
000000000002000000060000000006000000000020000000
00B000000000000000010000000001000000000000000003