000000020000001000000000000001000000000000000000
000400000000001000000000000001000000000000000000
000000000000001000000000000001000000000000000000
000000000000001000000000000001000000000000000000
300016161100001000011111100001000111111111111000
005010000100001000000000100000000100000100000000
000010000100001000000000100000000100000100000000
000010000000001000000000100000000100000100000000
000010000000001000000000100000000100000100000000
000011111111111111110000111111000100000100011111
000000000100000000010000000001000100000100010000
000000000100000000010000000001000000000100010000
000000000100000000010000000001000000000100010000
000000000100000000010000000001000000000100010000
111110000100001111110000100001000000000100010000
000000000000001000000000100001111111111100000000
000000000000001000000000100000000010000000000000
000000000000001000000000100000000010000000000000
000000000000001000000000100000000010000000000000
000011111111111000010000111111111110000011111111
000000000000000000010000000001000000000000000000
000000000000000000010000000001000000000000000000
000000000000000000010000000001000000000000000000
000000000000000000010000000001000000000000000000